111111111111111111111111
100010000000000000000001
100011111111100000000001
100000000000000000000001
100000000000000000000001
100000000000011111111111
100000000000010000000001
100000000011110000000001
100000000000000000000001
111111111111111111111111