111111111111111111111111
100020000000000000000001
100023333333300000000001
100000000000000000000001
100000000000000000000001
100000000000011111111111
100000000000010000000001
100000000011110000000001
100000000000000000000001
111111111111111111111111